SO ./img/normal_cat.png        
NO ./img/jinx.png      
EA ./img/looking.png               
WE ./img/floppa.png  


C 199,203,240
F 31,4,4

        111111 1111111111111111111
        100001 1001100000000000001
        10110111011100000110011101
        1001000000000000000001 101
111111111011000001110000000001 101
10000000001100000111011111D111 111
11110111111111011100000010001
11110111111111011101010010001
11000000110101011100000010001
10000000000000001100000010001
10000000000000001101010010001
11000001110101011111011110N01
11110111 1110101 101111010001
11111111 1111111 111111111111
