SO ./img/normal_cat.png        
NO ./img/jinx.png      
EA ./img/looking.png               
WE ./img/floppa.png  


C 199,203,240
F 31,4,4

       1
      101
     10001
    1000001
   1000W0001
  10000D00001
 1000000000001
111111111111111