SO ./img/normal_cat.png        
NO ./img/jinx.png      
EA ./img/looking.png               
WE ./img/floppa.png  


C 199,203,240
F 31,4,4

1111111     1111111
1000001111111000001
100E000000000000001
1000001111111000001
1111111     1111111