SO ./img/malveillance.png        
NO ./img/malveillance.png      
EA ./img/malveillance.png               
WE ./img/malveillance.png  




C 11a4,250,11
F 220,100,0

1111111111111111111111111
1000000000000N00000000001
1001111111111001111111001
1001001000000000001001001
1111111111110011111111111
           1001
           1001
           1001
           1001
           1111
