SO ./img/malveillance.png        
NO ./img/malveillance.png      
EA ./img/malveillance.png               
WE ./img/malveillance.png  

C 55,87,47
F 31,4,4

1111111111111
1000000000001
1111111111111
