C 255,255,255
F 0,0,0

        11111111111111111111111111
        10000000011000000000000001
        10110111011100000110011101
        10010000000000000000000001
1111111110110000011100000000000001
10000000001100000111011111D1111111
11110111111111011100000010001
11110111111111011101010010001
11000000110101011100000010001
100N0000000000001100000010001
10000000000000001101010010001
11000001110101011111011110001
11110111 1110101 101111010001
11111111 1111111 111111111111
